R    700 500

NO textures/eagle.xpm
WE textures/eagle.xpm
SO textures/bluestone.xpm
EA textures/girl.xpm

S textures/barrel.xpm

F 128,128,128
C 127,255,212

    111111111111111111111 111111 1
11111000000000000020000211110000111
10011110000100000200111100001110001
1001000000000000000020200S000000001
10010000000100000000111100001110001
100000000001000000021  100001 11111
100011111111000000001  100001
100000000000002000001  100001
111111110011111111111  100001
       1001            100001
11111111001111111111111000001
10000000000000000000000000001
10000011000000000000000000001
10011000000000000000000000001  11
1110000000000111111000000000111001
100001110000010000010000000000001
100001 100000100000011100000111111
10000111000001000000000000001
10000000000000100000000000001
10000000000000010000000000001
11111111111111111111000000001
11111111111111111111222222221
10000000000000000000000000001
1111111111111111111111111111
1111111111111111111111111111