R    1400 900

NO textures/eagle.xpm
WE textures/eagle.xpm
SO textures/colorstone.xpm
EA textures/eagle.xpm

S It's_sprite_texture

F 0,255,0
C 255,0,0


111111111111111111111  111111
100000000001000000001  100001
10000000000100000000111100001
10000000000100000000000000001
100000N0000100000000111100001
100000000001000000001  100001
100011111111000000001  100001
100000000000000000001  100001
111111111111111111111  100111
                       100001
11111111111111111111111100001
10000000000000000000000000001
10000000000000000000000000001
10000000000000000000000000001
10000000000000000000000000001
10000000000000000000000000001
10000000000000000000000000001
10000000000000000000000000001
10000000000000000000000000001
10000000000000000000000000001
11111111111111111111111111111