R    1600  900

NO Finally_something_works
WE It's_west_texture
SO It's_south_texture
EA It's_east_texture 

S It's_sprite_texture

F 0,255,0
C 255,0,0


111111111111111111111
100000000000000000001
100000000000000000001
100000000000111000001
100000N00000111000001
100000000000000000001
100000000000000000001
100000000000000000001
111111111111111111111