R    1440 900

NO textures/eagle.xpm
WE textures/greystone.xpm
SO textures/redbrick.xpm
EA textures/bluestone.xpm

S It's_sprite_texture

F 0,255,0
C 255,0,0


111111111111111111111  111111
100000000001000000001  100001
10011110000100000000111100001
100100000N0100000000000000001
10010000000100000000111100001
100000000001000000001  100001
100011111111000000001  100001
100000000000000000001  100001
111111110011111111111  100111
       1001            100001
11111111001111111111111100001
10000000000000000000000000001
10000000000000000000000000001
10000000000000000000000000001
10000000000001000000000000001
10000000000001000000000000001
10000000000001000000000000001
10000000000001000000000000001
10000000000000000000000000001
10000000000000000000000000001
11111111111111111111111111111