R    1440 900

NO textures/eagle.xpm
WE textures/redbrick.xpm
SO textures/bluestone.xpm
EA textures/bluestone.xpm

S textures/barrel.xpm

F 128,128,128
C 165,42,42


111111111111111111111  111111
100000000001002000021  100001 11111
10011110000100000200111100001110001
100100000N0000000000202000000000001
10010000000100000000111100001110001
100000000001000000021  100001 11111
100011111111000000001  100001
100000000000002000001  100001
111111110011111111111  100001
       1001            100001
11111111001111111111111100001
10000000000000000000000000001
10000011000000000000000000001
10011000000000000000000000001
11100000000001111110000000001
10000000000001000001000000001
10000000000001000000111000001
10000000000001000000000000001
10000000000000100000000000001
10000000000000010000000000001
11111111111111111111111111111